###################################################
#@.........#......................................#
#..........#......................................#
#..........#......................................#
#..........#......................................#
#..........#...............#########..............#
#..........#..............#.......................#
#..........#............##........................#
#..........#...........#..........................#
#..........#...........#...........################
#..........#..........#...........................#
#..........#.........#............................#
#..........#........#.............................#
#..........#........#########################.....#
#..........#........#.............................#
#..........#........#.............................#
#..........#........#.............................#
#..........#........###############################
#..........#........#.............................#
#..........#........#.............................#
#..........#........#.............................#
#...................#.............................#
#...................#..........####################
#...................#..........#..................#
#...................#...........#.................#
#................................###########......#
######............................................#
#.................................................#
###################################################