#####################     ################              ##############
#@..................#     #..............#            ###............#
#...................#######..............#            #.............##
#........................................#            #.............#
#...................#######..............#            #............##
#####################     #..............#            #............#
                          #..............#            #............#
                          #..............##############...........##
                          #############...................#########
                                      #...................#
                                      #...................#
                                      #...................#
                                      ###...............###
                                        ###...........###
                                          ###........###
                                            #........#
                                            #........#
                                            #........#
                                          ###........###
                                          #............#
                                          #............#
                                          #............#
                                          ##############