####################################
#.......#..........................#
#.......#..........................#
#.......#..........................#
#.......#............###############
#....................#
#....................#########
######.......................#
     #......................@#
     #......b................#
     #...............#########
     #...............#
     #...............#
     #################